SWWW000W00WWWW
0W00W00000W000
0W0000M0M000M0
000WWW0WW0W00W
W0WWWWW0W0WW00
W0W0WW0W00WWW0
W0WWWWWWM0WWW0
W000WW0000WWW0
00WWWW0WW0W000
0W0W000WWWW0WW
00000WWWW0000W
0W0000WWWW0W00
000WW0WW0W00W0
WW0W0000WW0WW0
00000WW0000W0A
