SWWW000W00WWWW0
0W00W00000W0000
0W0000M0M000M00
000WWW0WW0W00W0
W0WWWWW0W0WW000
W000WW0000WWW00
W0WWWWWWM0WWW00
W000WW0000WWW00
00WWWW0WW0W0000
0W0W000WWWW0WW0
00000WWWW0000W0
0W0000WWWW0W000
000WW0W00W00W00
WW0W0000WW0WW00
00000WW0000W0A0
