MMMMMMMMMMMMMMMMMM
M M  MM MM M   MMM
M M    MMM   M  MM
M   MMM MM M MM MM
MM MMMMM M MM   MM
MM M MM M  MMM M M
MM M MM  M MMM  MM
MM M MM    MMM M M
M  MMMM MM M   MMM
M M M   MMMM MMMMM
M MM  MMMM M  MMMM
M M  M MMMM M  MMM
M   MM MM MM M MMM
MMM MM MMMM MM  MM
M   M MMMMM M M  M
MMMMMMMMMMMMMMMM M
