S0MMMMMMMMMMMMMMMM
00M00MM0MM0M000MMM
M0M0000MMM000M00MM
M000MMM0MM0M0MM0MM
MM0MMMMM0M0MM000MM
MM M0MM0M00MMM0M0M
MM0M0MM00M0MMM00MM
MM0M0MM0000MMM0M0M
M00MMMM0MM0M000MMM
M0M0M000MMMM0MMMMM
M0MM00MMMM0M00MMMM
M0M00M0MMMM0M00MMM
M000MM0MM0MM0M0MMM
MMM0MM0MMMM0MM00MM
M000M0MMMMM0M0M00M
MMMMMMMMMMMMMMMM0A
